########
#.. P  #
#oo  # #
#      #
########