##########
#        #
# o  ### #
#  o  oP #
####   ###
# # ...# #
# #    # #
# #    # #
##########